11111111111
10001000101
10101010101
10100010101
10111111101
10001000101
11101010101
10001010101
10111010101
10000010001
11111111111